7 7
b . . . . . b
. b . . . . .
. . b . . . .
. . . . . . .
. . . . b . .
. . . . . b .
b . . . . . b
